wwwwwwwwwwwwwwwwwwwwwwwwwwwwwwww
w...............w..............w
w.......@.......w......ooo.....w
w...............w..............w
w...............w..............w
w...............w..............w
w...............g..............w
w...............w..............w
w...............w..............w
w...............w..............w
w.......g.......w......g.......w
w...............w..............w
wwwwwwwwwwwwwwwwwwwwwwwwwwwwwwww